%%%%%%%%%%%%%
%P1000900080%
%02050104090%
%03060205010%
%04070306020%
%00080007000%
%%%%%%%%%%%%%
# 10 -10 -10 -10 -10 -10 -10 -10 -10 -10 False