%%%%%%%%%%%%%%%%%%%%%%%%%%%%%%
%777000666 333    55 999 P555%
%777000666 333   55  999  555%
%666   555 666  11   888  666%
%666   555 666 11    888  666%
%666   555 66611     888  666%
%999111888 999       777  777%
%999111888 999       777  777%
%444       88811     666  888%
%444       888 11    666  888%
%444       888  11   666  888%
%555       777   22  33344999%
%555       777    22 33344999%
%%%%%%%%%%%%%%%%%%%%%%%%%%%%%%
# -10 10 10 10 10 -10 -10 -10 -10 10 True