%%%%%%%%%%%%
%9876543210%
%P         %
%0369  1472%
%          %
%0123456789%
%%%%%%%%%%%%
# 10 -10 10 -10 10 -10 10 -10 10 -10 False