%%%%%%%%%%%%%%%%%%%%%%
%987654321  876543210%
%P                   %
%0369  14720369  1472%
%                    %
%012345678  123456789%
%987654321  876543210%
%                    %
%0369  14720369  1472%
%                    %
%012345678  123456789%
%%%%%%%%%%%%%%%%%%%%%%
# 10 -10 10 -10 10 -10 10 -10 10 -10 True