%%%%%%%%%%%
%87 32 2P0%
%65 6  1 4%
%4  10 993%
%%%%%%%%%%%
# -10 -10 -10 -10 -10 10 10 10 10 10 False