13 7
classifier
%%%%%%%%%%%%%
%  %A  PO % %
%  %  AA O  %
%      %A  %%
%    %%  %  %
%   O     G %
%%%%%%%%%%%%%
-10 10
0 1 2 3 4 5 6