13 7
classifier
%%%%%%%%%%%%%
%P  A   O   %
%     AA O  %
%       A   %
%           %
%   O       %
%%%%%%%%%%%%%
-10 10
0 1 2 3 4 5 6