%%%%%%%%%%%%%%%%%%%%%%%%%%%% 
%P                    %    %
%                     %    %
%                     %    %
%                     %%%%%%
%                          %
%            %             %
%            %        .    %
%            %             %
%%%  %%%%%%%%%%%%%%      %%%
%     .%                   %
%     .%                   %
%      %              .    %
%      %                   %
%      %                   %
%                   %%%%%%%%
%      %            .      %
%      %                  .%
%      %         .         %
%%%%%%%%%%%%%%%%%%%%%%%%%%%%