%%%%%%%%%%%%%%%%%%%%%%%%%%%%%%%%%%%%%
%P2101910180019101800191018001910180%
%02050404091504040915040409150404091%
%13161215130612151306121513061215130%
%04070306021703060217030602170306021%
%10181017100810171008101710081017100%
%%%%%%%%%%%%%%%%%%%%%%%%%%%%%%%%%%%%%
# 10 10 -10 -10 -10 -10 -10 -10 -10 -10 True