%%%%%%%%%%%%%%%%%
% ..  .  . .  . %
% .P. . .  .  . %
% . . ..   .  . %
% ..  .  o .  .G%
% .   ..   .  . %
% .   . .  .  . %
% .   .  .  ..  %
%%%%%%%%%%%%%%%%%
